 #######
 #  #  #####
##  #  #...###
#  $#  #...  #
# $ #$$ ...  #
#  $#  #... .#
#   # $########
##$       $ $ #
 #  #  $$ #   #
 ######  ##$$@#
      #      ##
      ########
