  ######
  #   @####
##### $   #
#   ##    ####
# $ #  ##    #
# $ #  ##### #
## $  $    # #
 # $ $ ### # #
 # #  $  # # #
 # # #$#   # #
## ###   # # ######
#  $  #### # #....#
#    $    $   ..#.#
####$  $# $   ....#
#       #  ## ....#
###################
