      ############
     ##..    #   #
    ##..* $    $ #
   ##..*.# # #$ ##
   #..*.# # # $  #
####...#  #    # #
#  ## #          #
# @$ $ ###  # # ##
# $   $   # #   #
###$$   # # # # #
  #   $   # # #####
  # $# #####      #
  #$   #   #   #  #
  #  ###   ##     #
  #  #      #    ##
  ####      ######