   #######
  ##  *  ##
 ## .$ $. ##
## .$.$.$. ##
# .$.$.$.$. #
# $.$.$.$.$ #
#  $.$@$.$  #
# $.$.$.$.$ #
# .$.$.$.$. #
## .$.$.$  ##
 ## .$.$. ##
  ##     ##
   #######
