#####################
#            @      #
#.$.$.$*$.$.$.$.$.$ #
# *$* * *$* * *$* * #
#.$.$.$.$. .$.$.$.$ #
# * *$* *$* *$* * * #
#. .$.$.$.$*$.$.$*$ #
# .$. . . . . . .   #
#####################
