#############
#@          #
# .$.$.$.$. #
# $###$###$ #
# .#  .$ #. #
# $# . . #$ #
# .$.$*$.#..#
# $# . .  $ #
# .# $.  # $#
# $###$###$ #
# .$.$.$.$. #
##          #
 ############
