      ##############
     ##            #
    ##.$.$.$.$.$.$ #
   ##.$.$.$.$.$.$ ##
  ##.$.$.$.$.$.$  #
 ##.$.$.$.$.$.$ ###
##.$.$.$.$.$.$  #
#.$.$.$.$.$.$ ###
# .$.$+$.$.$  #
###############
