     #####
   ###   ###
  ## * $   ##
 ##   * *   ##
## * * * * * ##
#   * * * *   #
#  * * . * * *#
# $ * .@. * $ #
#* * * . * *  #
#   * * * *   #
## * * * * * ##
 ##   * *   ##
  ##   $ * ##
   ###   ###
     #####
