############
#  @       ##
# $.$.$.$.$ #
# .$.$#$.$. #
# $.$. .$.$ #
# .$# * #$. #
# $.$. .$.$ #
# .$.$.$.$. #
##          #
 ############
