#############
#@    #     #
# $.$.$.$.$ #
# .$.$.$.$. #
# $.$.$.$.$ #
##.$.$.$.$.##
# $.$.$.$.$ #
# .$.$.$.$. #
#           #
#############
