############
#@         ##
# $.$.$.$.$ #
# .$.$.$.$. #
# $.$.$.$.$ #
# .$.$.$.$. #
# $.$.$.$.$ #
# .$.$.$.$. #
##         ##
 ###########
