    ########
#####  @   #
#  $. . .$ #
# $.$.$.$.$#
# .$.$.$.$.##
#  .$.$.$.$ #
# .$.$ $.$  #
# $.$.$.$.  #
##.$.$.$.$. #
 #$.$.$.$.$ #
 # $. .$.$  #
 #      #####
 ########
