     #####
   ###   ###
  ##  .    ##
 ##  * * *  ##
##  * * * *  ##
#  * * * * *  #
# * * $ $ * * #
#. * * @ * * .#
# * * $ $ * * #
#  * * * * *  #
##  * * * *  ##
 ##  * * *  ##
  ##    .  ##
   ###   ###
     #####
