      ###############
     ##       .$    #
    ## .$.$.$.$.$   #
   ## .$.$.$.$.$.$ ##
  ## .$.$.$*$.$.$ ##
 ## .$.$.$.$.$.$ ##
## .$.$.$.$.$.$ ##
# .$.$.$.$.$.  ##
#@    $.      ##
###############
