#############
#@       $ .#
# $.$.$.$.$ #
# *$* * * * #
# $. *$. .$ #
# * * *$* * #
#  .$.$.$*  #
# * * * * * #
#. .       .#
#############
