############
#   #      ##
#  $.   .$  #
#.$.$. .$.$.#
#$.$.$ $.$.$#
#.$ $.$.$ $.#
#$.$*$.$*$.$#
#.$.$.@.$.$.#
#$.$.$.$.$.$#
#.$.$. .$.$.#
# .$.$.$.$. #
#           #
#############
