#############
#.  @   $  .#
#  $.$* .$. #
# $. * *$.$ #
#$.$* . * . #
#  * .$. *$ #
# * *$*$* * #
# $* .$. *  #
# . * . *$.$#
# $.$* * .$ #
# .$. *$.$  #
#.  $      .#
#############
