#############
#           #
# *$*$*$*$* #
# $. . . . .#
# * *$*$*$* #
# $.$. . .$.#
# * * @$* * #
# $.$. .$.$.#
# * *$*$* * #
# $. . . .$.#
# *$*$*$*$* #
#    . . . .#
#############
