  #######
 ##@    ##
## .$*$. ##
# .$* *$. ##
#.$* . . . ##
# * .$.$*$  #
#.$* *$* *$ #
# .$. . . * #
## *$* . *$ #
 ## .$* *$  #
  ## .$*$  ##
   ##     ##
    #######
