 #####
 #.@ ###
##*#$$ #
#      #
#   #  #
##.## ##
 #    #
 ######
