#####
#   ####
# $    ##
##$#*.  #
# $ ..  #
# @ ##  #
#########
