#####
#   #######
# #       #
#   # ### #
# ... .$. #
## ##### ##
#      $$ #
# #$$  #  #
# @ #  #  #
#####  ####
    ####
