         ####
    ######  #
    # ..... #
  ### .###* #
  #   *## . #
  # #    $. #
  # $ # $$###
####  ### #
#  #  #   #
# $$$$    #
#    ######
## @##
 ####
