        #####
        #   ##
        #    #
##########*# #
#         .# #
#  ####### # #
## #     # # #
 # # *** # # #
 # # * * # # #
 # # * . # # #
 # # # $ # # #
 # # ***## # #
 # #       # #
 # ##$####*# #
 #     @     #
 #  ##########
 ####
