 ##############
##            #
#  ********** #
#  *  @  *  * #
#  * *# *# ** #
## *  *$ *  * #
 # *  * .*  * #
 # ** #* #* * #
 # *  *     * #
 # ********** #
 #            #
 ##############
