############
#   #   #  #
# $        #
##$######  #
 #.*.##   ##
 #..* # $  #
###..@##$# #
#   ####   #
# $   ## ###
#  #  $   #
####  #   #
   ########
