##### #####
#   # #   #
# $*###*$ #
#  *   *  #
## * # * ##
 # ..*.. #
## * # * ##
#  *   *  #
# $*###*$ #
#   # # @ #
##### #####
