   ####
   #  ####
   #     #
 ### ##  #
 # .. # ##
 #..  # #
 # #### ##
## # $   #
#  # $$$ #
#  @  #  #
####  ####
   ####
