      # # # #
   # ######### #
  # #        ## #
 # #  $ * * *  #
  ## * *** * * # #
##  * *@* * * * # #
 # * * * * * *  ## #
##  *** * * * *  ##
 # * * * *** * *  .#
##  * * * # * * *  ##
 ##              #####
  ################
   ##        ##
