 #######
 #     #
 #$.*.$##
 # * *  #
 #$. .$@#
## * * ##
# $.*.$#
#      #
########
