    #######
   ##  #  #
  ## $.   #
 ## $. #  #
## $.  # ##
# $. ### #
# . ## # ##
##$#####  #
 #        #
 #@ #######
 ####
