   ########
   #   #  ##
  ##  $  $ ##
 ##  * # .$ ##
##  *  ## .$ ##
#  * ##### .$ #
# + ##   ## . #
#####     #####
