#########
#   #   #
#  ...  #
## ## ###
 #  $$$ #
 #  @   #
 ########
