  #######
###     #
# .**** #
# *   * #
# * # * #
# * #@* #
# ****$ ##
#        #
######   #
     #####
