#####
#@ .####
#. .   #
#$$ $  #
#  #####
#  #
####
