     #######
######  #  #
#  .  $. $ #
# ##.$. #  #
# # $.### ##
# #$. . # #
#  .#  .$ ##
###$###$#  #
 # $       #
 # @ ####  #
 #####  ####
