########
#      #
# $.*  #
##$## ##
#  .. #
#  *.$#
## .. #
 #$##$#
 # @$ #
 ###  #
   #  #
   ####
