 ##########
##        #
#   # # # ####
#.*.*.*.*.$ @#
# $ $ $ $    #
###########  #
          ####
