 ####
##  #####
#   #   #
#   # # ##
# $#  * .##
# $  # #. #
#*## # #. #
#      # *#
######$#  #
    #  @  #
    #  *  #
    #######
