        ######
    #####    #
    #   #  $ #
    # $ . #.###
######$## #.  #
#    ..+....  #
# #### ### #  #
# #    #   ####
# # $$$$$$$#
# #    #   #
# ###### ###
#        #
##########
