   #######
  ##  #  #
 ##  *   #
##  * #  #
#  *  # ##
# * ### #
#. ##   #
## #  ###
#  $ ##
# @###
#  #
####
