       #
      # #
     # . #
    # .$. #
   # .$.$. #
  #  $.$.$  #
 #  $.$#$.$  #
# .$.$.$.$.$. #
 # .$.$.$.$. #
  # .$.$.$. #
   # .$.$. #
    # .$. #
     # . #
   ###$$$###
   # $ $ $ #
   #   @   #
   #########
