 ######
 #    #
##. $ #
# .#$###
# . $  #
##  @  #
 #######
