#############
#     #     #
# $##$# $ $ #
#     ### # #
# $#..... # #
#  #.#$#. $ #
####.$@$.####
# $ . # .#  #
# # .....#$ #
# # ###     #
# $ $ $$##$ #
#     #     #
#############
