    #######
    #  #  #
    #  $  #
##### ##  #
# ..#. # ##
# .. . # #
## ##### ##
 # # $ $$ #
 # #  @$  #
 #   $#   #
 ##   #####
  #####
