     #####
   ###   #
  ##   # #
  #      #
 ## ##$###
 # .# $  #
 #.*$ $# #
##. # $  #
#  *# $# #
#...# @  #
##########
