#####   ####
#   #####  #
#        $ #
## ######  #
#.$$ $  # ##
#.....    ##
##$######  #
# $   @    #
#   ########
#####
