 ######
 #    #
## ## #
#   **#
# $   #
##$#..#
 # ## #
 #  @ #
 ######
