   #########
   #       #
#### ***** ####
#  # *   * #  #
# $$ * $ *... #
#  # *   * #  #
## # ***** # ##
 # #   @   # #
 # ######### #
 #           #
 #############
