 #####
 # @ ###
##$$$$ #
#  # # #
#  ....#
#  #   #
########
