#####     ####
#   #######  #
# $        $ #
## ########  #
 # *   #  #.##
 # # $  ..#  #
 # ##$##..   #
 # #   $..####
## # $ #..  #
#  # #### # #
# $$   @  $ #
#  ##########
####
