    #######
    #  #  #
    #     #
#####.##  #
# ..#  # ##
# ..$  # #
## ##### #
 # # $ $ ##
 # # $@$  #
 #    #   #
 ##   #####
  #####
