##########
####     #
# .$.$.$ #
# $.$.$. #
# .$##.$ #
# $.##$. #
# .$.$.$ #
# $.$.$. #
#@    ####
##########
