#########
#   #   #
# $ . . #
##$# #$##
# . . $ #
#     @ #
#########
