  ########
 ##  #   #
 # .     #
 # .### ##
 # .. # #
##$##$# #
#    $  #
#   #$# #
#####@  #
    #####
