########
#      #
# #... #
#   # ##
##$$$ #
 #  @ #
 ######
