#########
#  #    ###
#    $$$  #
#  ###@$  #
#...##$ ###
#  .# $ #
##. # $ #
 #. #   #
 #. *   #
 ########
