        #####
        #   ##
        # $  #
##########.# #
#  *     # # #
#  * *** # # #
## * * * # # #
 # * * . # # #
 # * * $ # # #
 # * *#### # #
 # *       # #
 #.*#$####*# #
 #     @     #
 #############
