#############
#           #
# ######### #
# #       # #
# # ##### # #
# # # @ # # #
# # # # # # ##
# # #    $.  #
# # #####$.  #
# #      $.###
# #######$.#
#        $.#
#########$.#
        #  #
        ####
