      ####
#######  #
#   $ $ $#
#  ..... #
##$.$$$.$#
 # .#@#. #
 #$.$$$.$##
 # .....  #
 #$ $ $   #
 #  #######
 ####
