  #####
###   #
# @$# ##
# *$.  #
#  #   #
##.# ###
 #   #
 #####
