#####     ####
# . ##   ## .#
# $. ##### * #
## $. ##  *  #
 ## $. # *  ##
  ## $  $  ##
   ##  #  ##
   ##### ##
   #   #  ##
  ##  $  $ ##
 ##  * # .$ ##
##  *  ## .$ ##
#  * ##### .$ ##
# + ##   ## .  #
#####     ##   #
           #####
