        ############
        #          #
        # ***** #  #
        # *   **$  #
######### * # @ #  #
#       # * ########
# ***** # *    #
# *   * # **** #
# * # * #    * #
# * # * #### * #
# * # *      * #
# * # ******** #
# . #          #
################
