####     ####
#  #######  #
#       . * #
#  ### * #  #
## #  * ## ##
#  # *  ## #
# $ * #### ##
#  ##$####  #
#### .      #
   # @ ###  #
   ##### ####
