    #####
    #   ####
    #      #
######.##$@#
#     .   ##
# # ##.##$##
# # # ...  #
# #$ $ $ $ #
#   ########
#####
