  #######
###     #
# .**** #
# #   * #
# # # * #
# # #@* #
# #***$ ##
#        #
######   #
     #####
