    #####
#####   #
#    $  #
#..****##
#    $ #
### ## #
  #   @#
  ######
