     #######
     #     #
###### ###$##
#   # *   + #
#     * * * #
#### ###### #
   #        #
   ##########
