   ####
   #  ####
   #     #
####$##  #
# ..  # ##
# ..  # #
## #### ##
##.# $   #
#  # $$$ #
#     #@ #
#  #######
####
