#####
#  @##
# #$ ####
# #  # .#
# #$    #
# #  #  #
# #$ #*##
# # ##  #
# . .   #
####   ##
   #####
